w w w w w w w w w w w w w w w w w w w w w w w w w w w w
w s s s s s s s s s s s s w w s s s s s s s s s s s x w
w s w w w w s w w w w w s w w s w w w w w s w w w w s w
w s w e e w s w e e e w s w w s w e e e w s w e e w s w
w s w w w w s w w w w w s w w s w w w w w s w w w w s w
w s s s s s s s s s s s s s s s s s s s s s s s s s s w
w s w w w w s w w s w w w w w w w w s w w s w w w w s w
w s w w w w s w w s w w w w w w w w s w w s w w w w s w
w s s s s s s w w s s s s w w s s s s w w s s s s s s w
w w w w w w s w w w w w e w w e w w w w w s w w w w w w
e e e e e w s w w w w w e w w e w w w w w s w e e e e e
e e e e e w s w w e e e e e e e e e e w w s w e e e e e
w w w w w w s w w e w w w g g w w w e w w s w w w w w w
t e e e e e s e e e w a a a e a a w e e e s e e e e e t
w w w w w w s w w e g e e e e e e g e w w s w w w w w w
e e e e e w s w w e w a a a e a a w e w w s w e e e e e
e e e e e w s w w e w w w g g w w w e w w s w e e e e e
e e e e e w s w w e e e e e e e e e e w w s w e e e e e
w w w w w w s w w e w w w w w w w w e w w s w w w w w w
w s s s s s s s s s s s s w w s s s s s s s s s s s s w
w s w w w w s w w w w w s w w s w w w w w s w w w w s w
w s w w w w s w w w w w s w w s w w w w w s w w w w s w
w s s s w w s s s s s s s s s s s s s s s s w w s s s w
w w w s w w s w w s w w w w w w w w s w w s w w s w w w
w w w s w w s w w s w w w w w w w w s w w s w w s w w w
w s s s s s s w w s s s s w w s s s s w w s s s s s s w
w s w w w w w w w w w w s w w s w w w w w w w w w w s w
w s w w w w w w w w w w s w w s w w w w w w w w w w s w
w x s s s s s s s s s s s s s s s s s s s s s s s s x w
w w w w w w w w w w w w w w w w w w w w w w w w w w w w